R  1080 720
NO ./textures/redbrick.xpm
SO ./textures/bluestone.xpm
WE ./textures/wood.xpm
EA ./textures/greystone.xpm

S ./textures/greenlight.xpm
F ./textures/mossy.xpm
C ./textures/colorstone.xpm
        1111111111111111111111111
		1000000000110000000000001
		1011000001110000000000000
		1001000000000000000000001
111111111011000001110000000000001
100000000011000001110111111111111
11110111111111011100000010001    
11110111111111011101010010001 
11000000110101011100000010001
10000000000000001100000010221
10000000000000001101010000001
11000001110101011111011110W01
11110111 1110101 101111010001
11111111 1111111 111111111111
