R 642982 516464

NO ./textures/brick.xpm
SO ./textures/blue.xpm
WE ./textures/wood.xpm
EA ./textures/grey.xpm

S ./textures/greenlight.xpm
F 100,0,100
C 0,0,0

11111111111111111111111111111
10000000000000000000000000001
1222222222222S222222222222211
11111111111111111111111111111